Weston	Gleason	Tustin	NJ
Cordell	Hudson	Newark	WI
Gardner	Nienow	Willmsville	MO
Kamron	Bruen	The Hammocks	WY
Pat	Hintz	North Alanisside	RI
Agustin	Champlin	O'Reillyfort	NV
Alfred	Herzog	Maggiobury	DE
Murl	Smitham	South Wyatt	CT
Irma	Deckow	Brendenburgh	AR
Adonis	Kirlin	Beckerfurt	WV
Jessy	Gerhold	Alafaya	AR
Zackery	Walter	Kulasmouth	NM
Rafaela	Upton	North Kristofertown	WY
Stone	Tremblay	North Ledashire	ID
Adrian	Farrell	Rocky Mount	NC
Hector	Hodkiewicz	Huelhaven	DE
Stephanie	Graham	Alanisborough	IL
Betsy	Waelchi	Shemarside	TX
Uriah	Yost	Maricopa	MI
Rowland	Terry	Port Okeystad	MI
Herminia	Hartmann	Bechtelarfort	MI
Helene	Grimes	Rickyside	AL
Lavonne	Senger	New Hanstown	VT
Nikita	Koss	Rachelton	WY
Juanita	Walter	Phyllishaven	IL
Adriana	Fay	Lake Savannah	ID
Crawford	Krajcik	Harbertown	MD
Alfredo	Durgan	Port Heaven	CT
America	Prosacco	Berniermouth	MN
Theresa	Lang	Freedaberg	WA
Itzel	Morissette	Ornborough	CO
Geovanny	Dibbert	Medford	PA
Claire	Jast	New Elviefurt	OR
Mary	Koch	Margate	OR
Elva	Bashirian	West Antonio	IA
Eden	Pollich	Rubymouth	OK
Jamal	Bernhard	New Anjali	IA
Webster	Carter	South Luciemouth	VA
Francis	Gaylord	East Patport	AL
Rosanna	Corwin	East Emilio	VA
Eleanora	Bernier	East Lyric	MD
Arielle	Sawayn	Angelicaport	IL
Hilma	Barrows	Port Romaine	NE
Rudolph	Hamill	South Casimir	MS
Madilyn	Armstrong	South Breanabury	OH
Marcella	Bartoletti	East Celia	FL
Nichole	Farrell	Williamsonstad	WV
Heloise	Klein	Lake Deion	KS
Candace	Dickinson	Fairfield	WV
Maureen	Senger	Quitzonchester	NY
Adrian	Rodriguez	Goyetteview	CT
Elaina	Kutch	Lynwood	GA
Giovanna	Cummings	North Emilia	ID
Carmella	Koss	Antelope	RI
Gennaro	Witting	Krajciktown	IN
Pinkie	Wyman	Rosannashire	CT
Heath	Carter	Lake Tate	FL
Glennie	Renner	Ceceliabury	MN
Maryjane	O'Conner	McLaughlinmouth	SD
Taylor	Huels	Euclid	FL
Gertrude	Schroeder	Homenickside	OK
Alice	Cruickshank	Boyerchester	OR
Monica	McGlynn	Lake Ron	GA
Candelario	Schuppe	South Eleanorashire	TN
Elaina	Weimann	Abbottfurt	AZ
Lavern	Hilll	Waldorf	WA
Shanon	Nitzsche	Wilfridborough	CA
Nikki	Hills	Buckeye	WI
Gerald	Ferry	Judeville	AL
Rolando	Jacobi	Marlinview	IL
Tyrique	Windler	Swiftchester	IL
Jerrod	Flatley	San Jacinto	OK
Laurianne	Wuckert	New Adolfohaven	CT
Justine	Schinner	Port Elvieberg	DE
Coleman	Metz	North Yoshiko	CO
Gustave	Shields	Lubbock	TN
Bettye	Oberbrunner	Decatur	AZ
Dorian	Hodkiewicz	St. Petersburg	SD
Frank	Paucek	Daltonton	RI
Aniya	Borer	South Trevorstad	NV
Kira	Gaylord	Akron	OH
Karlie	Steuber	Wilhelmton	SD
Litzy	Luettgen	Bedford	ID
Adell	Mosciski	Plymouth	MN
Sasha	Mills	Amaramouth	KY
Dedric	Grady	Pacochahaven	SD
Toy	Roob	Columbia	WY
Ryan	Marks	South Irvingchester	NC
Maryam	Quitzon	Lake Heatherborough	NV
Melba	Kohler	Idaho Falls	ID
Vesta	Rempel	Colefurt	MA
Brigitte	Hegmann	Port Giovanna	IL
Pink	Reilly	North Katelyntown	MA
Kamryn	Skiles	North Port	TN
Emmie	Hoeger	Kaitlinchester	AZ
Burley	Miller	Sunrise Manor	NM
Isadore	Kihn	Abernathytown	MS
Olaf	Bechtelar	Strackeshire	AK
Rhett	Wilkinson	Port Jarodborough	AK
Zoey	Swift	Lake Carleton	MA
